EAEEWEEEEE
EEEWEEDEEE
EEEWEEEEEE
EEEWEEEEEE
EEEEWEEEEE
EEEEEEEEEE
EEEEEEEEEE
EEEEEEEEEE
EEEEEEEEEE
EEEEEEEEEE
