WWEEWWEEWE
WEEEEEEEEW
WEEAEEEEEW
WEEEEEEEEW
WWEEEEEEWW
EEEEEEEEEE
EEEEEEEEEE
WWEEEEEEWW
WWEEEEEEWW
WWEEWWEDWW