EEEEWWWWWEEEEEEEEWWEE
EEEWEEEEWEEEEEEEWAWEE
EEWWEEEEEWEEEEEEWEEWE
EWEEEEEEEWEEEEEWEEEWE
EWEEEEEEEEWEEEEWEEEEW
WEEEEDWEEEWEEEWEEEEEW
WEEEEWWEEEEWEEEWEEEEW
WEEEEWWEEEEWEEEWWEWWE
EWEEEEEEEEEEWEEEWEWEE
EWWWEEEEEEEEWWWWEEWEE
EEEEWWWEEWEEEWWEEEWEE
EEEEEWEEWEEEEEEEEWEEE
EEEEEWEEEWWEEEEEWWEEE
EEEEWEWEEEEEEEWWEEEEE
EEEEEWWWEEEEEWWEEEEEE
EEEEEEEWWWWEWWEEEEEEE
EEEEEEEEEWEEEWEEEEEEE
EEEEEEEEEWWWWEEEEEEEE
